NO          textures/red.xpm
SO  textures/blue.xpm
WE        textures/red.xpm
EA    textures/brickwall.xpm

F 0
C 158,199,228

		11111111111111111111111111111
		100000000000000000000000001
		100000000000000000000000001
		100000000100000011110000001
		100000001000000100001000001
		100000010000000000000100001
		100000100000000000000100001
		100001000010000000001000001
		100010000010000000010000001
		100111111110000001100000001
		100000000010000011000000001
		100000000010001101111000001
		100000000000N00000000000001
		11111111111111111111111111111

		11
		101
		111