NO          textures/red.xpm
SO  textures/blue.xpm
WE        textures/red.xpm
EA    textures/rose.xpm

F 0, 40, 0
C 158,199,228

11111111
10001001
10101001
10100E01
11 11111