NO          textures/red.xpm
SO  textures/blue.xpm
WE        textures/red.xpm
EA    textures/rose.xpm

F 0
C 158,199,228

	1111111
1000101
1010101
10100E1
1111111