NO         textures/red.xpm
SO  textures/blue.xpm
WE        textures/red.xpm
EA    textures/brickwall.xpm

F ,
C 158,199,228


	11111111111
100010100010
10101010000111111
1010001000000S0001
10100000111111111
101000001
10100000111
10100000001
11111111111