NO          textures/red.xpm
SO  textures/red.xpm    
WE        textures/red.xpm  
EA    textures/red.xpm               

F 0,20,0
C 0,40,255

111111
100101
101001
1100N1
111111