NO   textures/red.xpm
SO  textures/image.xpm
WE        textures/red.xpm
EA    textures/brickwall.xpm


F 0,40,0
C 158,199,228


111111
1N1
111
   
  