NO          textures/red.xpm
SO  textures/blue.xpm    
WE        textures/yellow.xpm  
EA    textures/rose.xpm       

F 20,30,20
C 158,199,228

1111111111
1001010001
1101000001
1100S10001
1100000111
11000001
1100000111
1100000001
1111111111