NO          ../textures/grados_0.xpm 
SO  ../textures/grados_0.xpm    
WE        ../textures/grados_0.xpm 
EA    ../textures/grados_0.xpm                 

F 
C                    

111111
100101
101001
1100N1
111111


