
NO  ./path_to_the_north_texture   
SO  ./path_to_the_south_texture   
WE  ./path_to_the_west_texture  
EA               

F 220,100,0  
C 225,30,0    

111111111111
100000000001
10N000000001
100000000001
100000000001                
100000000001
100000000001
100000000001
100000000001        
100000000001
111111111111